NO 	 ./treuc	
SO ./d 
WE       ee
EA  d
F    255,0,255
C    0,255,255




111111111111111111111111
1E0000000000000000000001
111110111110011111101111
100000000000000000000001
100000100000000000100001
100000100000000000100001
111101111110111111101111
100000000000000000000111
111111110110000000100111
111111111111111111111111
