NO ./assets/test.xpm
SO ./assets/test.xpm
WE ./assets/test.xpm
EA ./assets/test.xpm

F 42,42,42
C 42,42,42

11111
10001
1N001
10001
11111