NO ./assets/textures/wall.xpm
SO ./assets/textures/wall.xpm
WE ./assets/textures/wall.xpm
EA ./assets/textures/wall.xpm

F 220,100,0
C 225,30,0

1111111111111111111111111
1000000000110000000000001
1011000001110000000000001
10010000000000000000000011
11111111101100000111000001111
100000000011000001110111111111111
11110111111101011100000010001
11110111111101011101010010001
11000000110101011100000010001
1000000000000N001100000000001
10000000000000001101010010001
1100000111010101111101111000111
11110111 1110101 101111010001
11111111 1100111 111111111111
1111111111100111111111111
1000000000110000000000001
1011000001110000000000001
10010000000000000000000011
11111111101100000111000001111
100000000011000001110111111111111
11110111111101011100000010001
11110111111101011101010010001
11000000110101011100000010001
10000000000000001100000000001
10000000000000001101010010001
1100000111010101111101111000111
11110111 1110101 101111010001
11111111 1111111 111111111111