

1111111
 10001N1
1001001
1111111

1111111
110111
 1111




