NO ./asserts/wall_test.xpm
SO  ./asserts/wall_test.xpm
WE ./asserts/wall_test.xpm
EA ./asserts/wall_test.xpm
F   255,0,255
C    0,255,255




111111111111111
10000000000001111
1000000000000011
1E0000000000001
111111111111111
