NO 		 ./treuc	
SO ./d 
WE       ee
EA      ee
F    255,255,255
C    255,255,255


11011011    
10N1001
111111
