NO 	 ./treuc	
SO ./d 
WE       ee
EA  d
F    255,255,255
C    255,255,255

  1  1
11011011    
1001001
111111
