NO 		 ./treuc	
SO ./d 
WE      
F    255,255,0

1111111
10011011    
10N1001
1111111

 1111111
1010111
11111




