NO 		 ./treuc	
SO ./d 
WE       ee
EA      ee
F    255,255,255
C    255,255,255


111111
100101
101001
1100N1
111111