NO ./assets/logo.xpm
SO  ./assets/logo.xpm
WE ./assets/logo.xpm
EA ./assets/logo.xpm
F   255,0,255
C    0,255,255




111111111
100000111
1000000101
1E44001001
111110111
     1 