NO 	 ./treuc	
SO ./d 
WE       ee
EA  d
F    255,0,255
C    0,255,255

111111
100101
101001
1100N1
111111
