NO      ./assets/wall3.xpm
SO      ./assets/wall3.xpm
WE      ./assets/wall3.xpm
EA      ./assets/wall3.xpm
F    255,0,255
C    0,255,255




1111111111111111111111111
1010001000010000000011101
1010101001000001000010001
1E00000000000000000000001
1111111111111111111111111
