NO ./asserts/wall_test.xpm
SO  ./asserts/wall_test.xpm
WE ./asserts/wall_test.xpm
EA ./asserts/wall_test.xpm
F   255,0,255
C    0,255,255




1111111111111111111111111
1010001000010000000011101
1010101001000001000010001
1E00000000002000000000001
1111111111111111111111111
