NO 		 ./treuc
SO ./d
WE 
F    255,255,0

1111111
 1000101
1001001
1111111

1111111
1S10111
 1111




