NO 	 ./treuc	
SO ./d 
WE       ee
EA  d
F    255,0,255
C    0,255,255




1111111111111111111111111
1010101000000000000011101
1020303002200000000010001
1E00020000003000000200001
1111111111111111111111111
