NO 	 ./treuc	
SO ./d 
WE       ee
EA  d
F    255,0,255
C    0,255,255
    1111111111111111111111111111111111111111111111111111111111111111111111111111111111111111111111111111111111111111111111111111111111111111111111111111111111111111111111111111111111111111111111111111111111111111111111111111111111111111111111111111111111111111111111111111111111111111111111111111111111111111111111111111111111111111111111111111111111111111111111111111111111111111111111111111111111111111111111111111111111111111111111111111111111111111111111111111111111111111111111111111111111111111111111111111111111111111111111111111111111111111111111111111111111111111111111111111111111111111111111111111
    10000000000000000000000000000000000000000000000000000000000000000000000000000000000000000000000000000000000000000000000000000000000000000000000000000000000000000000000000000000000000000000000000000000000000000000000000000000000000000000000000000000000000000000000000000000000000000000000000000000000000000000000000000000000000000000000000000000000000000000000000000000000000000000000000000000000000000000000000000000000000000000000000000000000000000000000000000000000000000000000000000000000000000000000000000000000000000000000000000000000000000000000000000000000000000000000000000000000000000000000000N1
    100000010101010101010101110101010101010101010101010101010101010101010101010101010101010101010101010101010110101010101010101110101010101010101010101010101010101010101010101010101010101010101010101010101010110101010101010101110101010101010101010101010101010101010101010101010101010101010101010101010101010110101010101010101110101010101010101010101010101010101010101010101010101010101010101010101010101010110101010101010101110101010101010101010101010101010101010101010101010101010101010101010101010101010110101010101010101110101010101010101010101010101010101010101010101010101010101010101010101010101010101
    100000010101010101010101110101010101010101010101010101010101010101010101010101010101010101010101010101010110101010101010101110101010101010101010101010101010101010101010101010101010101010101010101010101010110101010101010101110101010101010101010101010101010101010101010101010101010101010101010101010101010110101010101010101110101010101010101010101010101010101010101010101010101010101010101010101010101010110101010101010101110101010101010101010101010101010101010101010101010101010101010101010101010101010110101010101010101110101010101010101010101010101010101010101010101010101010101010101010101010101010101
    100000000000000000000000000000000000000000000000000000000000000000000000000000000000000000000000000000000000000000000000000000000000000000000000000000000000000000000000000000000000000000000000000000000000000000000000000000000000000000000000000000000000000000000000000000000000000000000000000000000000000000000000000000000000000000000000000000000000000000000000000000000000000000000000000000000000000000000000000000000000000000000000000000000000000000000000000000000000000000000000000000000000000000000000000000000000000000000000000000000000000000000000000000000000000000000000000000000000000000000000001
    100000010101010101010101110101010101010101010101010101010101010101010101010101010101010101010101010101010110101010101010101110101010101010101010101010101010101010101010101010101010101010101010101010101010110101010101010101110101010101010101010101010101010101010101010101010101010101010101010101010101010110101010101010101110101010101010101010101010101010101010101010101010101010101010101010101010101010110101010101010101110101010101010101010101010101010101010101010101010101010101010101010101010101010110101010101010101110101010101010101010101010101010101010101010101010101010101010101010101010101010101
    1000000000000000000000000000000000000000000000000000000000000000000000000000000000000000000000000000000000000000000000000000000000000000000000000000000000000000000000000000000000000000000000000000000000000000000000000000000000000000000000000000000000000000000000000000000000000000000000000000000000000000000000000000000000000000000000000000000000000000000000000000000000000000000000000000000000000000000000000000000000000000000000000000000000000000000000000000000000000000000000000000000000000000000000000000000000000000000000000000000000000000000000000000000000000000000000000000000000000000000000000001
    1111111111111111111111111111111111111111111111111111111111111111111111111111111111111111111111111111111111111111111111111111111111111111111111111111111111111111111111111111111111111111111111111111111111111111111111111111111111111111111111111111111111111111111111111111111111111111111111111111111111111111111111111111111111111111111111111111111111111111111111111111111111111111111111111111111111111111111111111111111111111111111111111111111111111111111111111111111111111111111111111111111111111111111111111111111111111111111111111111111111111111111111111111111111111111111111111111111111111111111111111111
