NO ./asserts/wall_test.xpm
SO  ./asserts/wall_test.xpm
WE ./asserts/wall_test.xpm
EA ./asserts/wall_test.xpm
F   255,0,255
C    0,255,255




111111111
100001111
102020011
1E0001121
11111111
