NO 		 ./treuc	
SO ./d 
WE      
F    255,255,0

1111111
101 10110    
1001001
1111111

 1111111
1010111
11111




