NO ./asserts/wall_test.xpm
SO  ./asserts/wall_test.xpm
WE ./asserts/wall_test.xpm
EA ./asserts/wall_test.xpm
F   255,0,255
C    0,255,255




11111111
100000001
1000200001
1E0000001
111111111
