1111111
 10001N1
1001001
101 101
111101
 1111
