NO 	 ./treuc	
SO ./d 
WE       ee
EA  d
F    255,0,255
C    0,255,255

    1111
    1S1
    1111
