NO 	 ./treuc	
SO ./d 
WE       ee
EA  d
F    255,0,255
C    0,255,255
      11111111111111111111111111111111111111111111111111
     1100000000000000000000000000000000000000000000000011
    100S110100000000000000000100011111110011111111110011
     1100001111110000000011101101111100000000000000000001
      11110000000001110000000100000000001111111110000001
      100000000000000000000000000000000000000000000000001
      100000000000000000000100000000000000000000000000001
      11111111111111111111111111111111111111111111111111
