NO 	 ./treuc	
SO ./d 
WE       ee
EA  d
F    255,0,255
C    0,255,255
      11111
     11000011
    100S1101
     1100001
      11111
